219, 219, 219, 219, 219, 219, 219, 219, 219, 219, 219, 219, 219, 219, 219, 219, 219, 219, 219, 219, 219, 219, 219, 219, 219, 219, 219, 219,
219, 254, 254, 254, 254, 254, 254, 254, 254, 254, 254, 254, 254, 219, 219, 254, 254, 254, 254, 254, 254, 254, 254, 254, 254, 254, 254, 219,
219, 254, 219, 219, 219, 219, 254, 219, 219, 219, 219, 219, 254, 219, 219, 254, 219, 219, 219, 219, 219, 254, 219, 219, 219, 219, 254, 219,
219, 254, 219, 219, 219, 219, 254, 219, 219, 219, 219, 219, 254, 254, 254, 254, 219, 219, 219, 219, 219, 254, 219, 219, 219, 219, 254, 219,
219, 254, 219, 219, 219, 219, 254, 219, 219, 219, 219, 219, 254, 219, 219, 254, 219, 219, 219, 219, 219, 254, 219, 219, 219, 219, 254, 219,
219, 254, 254, 254, 254, 254, 254, 254, 254, 254, 254, 254, 254, 219, 219, 254, 254, 254, 254, 254, 254, 254, 254, 254, 254, 254, 254, 219,
219, 254, 219, 219, 219, 219, 254, 219, 219, 254, 219, 219, 219, 219, 219, 219, 219, 219, 254, 219, 219, 254, 219, 219, 219, 219, 254, 219,
219, 254, 219, 219, 219, 219, 254, 219, 219, 254, 219, 219, 219, 219, 219, 219, 219, 219, 254, 219, 219, 254, 219, 219, 219, 219, 254, 219,
219, 254, 254, 254, 254, 254, 254, 219, 219, 254, 254, 254, 254, 219, 219, 254, 254, 254, 254, 219, 219, 254, 254, 254, 254, 254, 254, 219,
219, 219, 219, 254, 219, 219, 254, 219, 219, 219, 219, 219, 254, 219, 219, 254, 219, 219, 219, 219, 219, 254, 219, 219, 254, 219, 219, 219,
219, 219, 219, 254, 219, 219, 254, 219, 219, 219, 219, 219, 254, 219, 219, 254, 219, 219, 219, 219, 219, 254, 219, 219, 254, 219, 219, 219,
219, 254, 254, 254, 219, 219, 254, 254, 254, 254, 254, 254, 254, 254, 254, 254, 254, 254, 254, 254, 254, 254, 219, 219, 254, 254, 254, 219,
219, 254, 219, 219, 219, 219, 254, 219, 219, 254, 219, 219, 032, 032, 032, 032, 219, 219, 254, 219, 219, 254, 219, 219, 219, 219, 254, 219,
219, 254, 219, 219, 219, 219, 254, 219, 219, 254, 219, 032, 032, 032, 032, 032, 032, 219, 254, 219, 219, 254, 219, 219, 219, 219, 254, 219,
219, 254, 254, 254, 254, 254, 254, 219, 219, 254, 219, 032, 032, 032, 032, 032, 032, 219, 254, 219, 219, 254, 254, 254, 254, 254, 254, 219,
219, 254, 219, 219, 219, 219, 254, 219, 219, 254, 219, 032, 032, 032, 032, 032, 032, 219, 254, 219, 219, 254, 219, 219, 219, 219, 254, 219,
219, 254, 219, 219, 219, 219, 254, 219, 219, 254, 219, 219, 219, 219, 219, 219, 219, 219, 254, 219, 219, 254, 219, 219, 219, 219, 254, 219,
219, 254, 254, 254, 219, 219, 254, 219, 219, 254, 254, 254, 254, 254, 254, 254, 254, 254, 254, 219, 219, 254, 219, 219, 254, 254, 254, 219,
219, 219, 219, 254, 219, 219, 254, 219, 219, 254, 219, 219, 219, 219, 219, 219, 219, 219, 254, 219, 219, 254, 219, 219, 254, 219, 219, 219,
219, 219, 219, 254, 219, 219, 254, 219, 219, 254, 219, 219, 219, 219, 219, 219, 219, 219, 254, 219, 219, 254, 219, 219, 254, 219, 219, 219,
219, 254, 254, 254, 254, 254, 254, 254, 254, 254, 254, 254, 254, 254, 254, 254, 254, 254, 254, 254, 254, 254, 254, 254, 254, 254, 254, 219,
219, 254, 219, 219, 219, 219, 254, 219, 219, 219, 219, 219, 254, 219, 219, 254, 219, 219, 219, 219, 219, 254, 219, 219, 219, 219, 254, 219,
219, 254, 219, 219, 219, 219, 254, 219, 219, 219, 219, 219, 254, 219, 219, 254, 219, 219, 219, 219, 219, 254, 219, 219, 219, 219, 254, 219,
219, 254, 254, 254, 219, 219, 254, 254, 254, 254, 254, 254, 254, 219, 219, 254, 254, 254, 254, 254, 254, 254, 219, 219, 254, 254, 254, 219,
219, 219, 219, 254, 219, 219, 254, 219, 219, 254, 219, 219, 219, 219, 219, 219, 219, 219, 254, 219, 219, 254, 219, 219, 254, 219, 219, 219,
219, 219, 219, 254, 219, 219, 254, 219, 219, 254, 219, 219, 219, 219, 219, 219, 219, 219, 254, 219, 219, 254, 219, 219, 254, 219, 219, 219,
219, 254, 254, 254, 254, 254, 254, 219, 219, 254, 254, 254, 254, 219, 219, 254, 254, 254, 254, 219, 219, 254, 254, 254, 254, 254, 254, 219,
219, 254, 219, 219, 219, 219, 254, 219, 219, 219, 219, 219, 254, 219, 219, 254, 219, 219, 219, 219, 219, 254, 219, 219, 219, 219, 254, 219,
219, 254, 219, 219, 219, 219, 254, 219, 219, 219, 219, 219, 254, 219, 219, 254, 219, 219, 219, 219, 219, 254, 219, 219, 219, 219, 254, 219,
219, 254, 254, 254, 254, 254, 254, 254, 254, 254, 254, 254, 254, 254, 254, 254, 254, 254, 254, 254, 254, 254, 254, 254, 254, 254, 254, 219,
219, 219, 219, 219, 219, 219, 219, 219, 219, 219, 219, 219, 219, 219, 219, 219, 219, 219, 219, 219, 219, 219, 219, 219, 219, 219, 219, 219,